XXXXXXXXXXXXXXXXXXXXXXXXXXXXXXXXXXXXXXXXXXXXXXXXXXXXXXXXXXXXXXXXXXXXXXXXXXXXXXXXXXXXXXXXXXXXXXXXXXX
X0000000000000000000000000000000000000000000000000000000000000000000000000000000000000000000000000X
X0004444444444444444444444444444444444444444444444444444444444444444444444444444444444444444440000X
X0004444444444444444444444444444444444444444444444444444444444444444444444444444444444444444440000X
X0000000000000000000000000000000000000000000000000000000000000000000000000000000000000000000000000X
X0000000000000000000000000000000000000000000000000000000000000000000000000000000000000000000000000X
X0000000000000000000000000000000000000000000000000000000000000000000000000000000000000000000000000X
X0000000000000022222222222222222222222222220000000000000000000000000000000000000000000000000000000X
X0000000000000022222222222222222222222222220000000000000000000000000000000000000000000000000000000X
X0000000000000022222222222222222222222222220000000000000000000000000000000333333300000000000000000X
X0000000000000022222222222222222222222222220000000000000000000000000000000333333300000000000000000X
X0000000000000022222222222222222222222222220000000000000000000000000000000333333300000000000000000X
X0000000000000022222222222222222222222222220000000000000000000000000000000333333300000000000000000X
X0000000000000022222222222222222222222222220000000000000000000000000000000333333300000000000000000X
X0000000000000022222222222222222222222222220000000000000000000000000000000333333300000000000000000X
X0000000000000022222222222222222222222222220000000000000000000000000000000333333300000000000000000X
X0000000000000022222222222222222222222222220000000000000000000000000000000333333300000000000000000X
X0000000000000022222222222222222222222222220000000000000000000000000000000333333300000000000000000X
X0000000000000022222222222222222222222222220000000000000000000000000000000333333300000000000000000X
X0000000000000000000000000000000000000000000000000000000000000000000000000333333300000000000000000X
X0000000000000000000000000000000000000000000000000000000000000000000000000333333300000000000000000X
X0000000000000000000000000000000000000000000000000000000000000000000000000333333300000000000000000X
X0000000555555555555555555555555555555555555555555500000000000000000000000333333300000000000000000X
X0000000555555555555555555555555555555555555555555500000000000000000000000333333300000000000000000X
X0000000555555555555555555555555555555555555555555500000000000000000000000333333300000000000000000X
X0000000555555555555555555555555555555555555555555500000000000000000000000333333300000000000000000X
X0000000555555555555555555555555555555555555555555500000000000000000000000333333300000000000000000X
X0000000555555555555555555555555555555555555555555500000000000000000000000333333300000000000000000X
X0000000555555555555555555555555555555555555555555500000000000000000000000333333300000000000000000X
X0000000555555555555555555555555555555555555555555500000000000000000000000333333300000000000000000X
X0000000555555555555555555555555555555555555555555500000000000000000000000333333300000000000000000X
X0000000555555555555555555555555555555555555555555500000000000000000000000333333300000000000000000X
X0000000555555555555555555555555555555555555555555500000000000000000000000333333300000000000000000X
X0000000555555555555555555555555555555555555555555500000000000000000000000000000000000000000000000X
X0000000555555555555555555555555555555555555555555500000000000000000000000000000000000000000000000X
X0000000555555555555555555555555555555555555555555500000000000000000000000000000000000000000000000X
X0000000555555555555555555555555555555555555555555500000000000000000000000000000000000000000000000X
X0000000555555555555555555555555555555555555555555500000000000000000000000000000000000000000000000X
X0000000000000000000000000000000000000000000000000000000000000000000000000000000000000000000000000X
X0000000000000000000000000000000000000000000000000000000000000000000000000000000000000000000000000X
X0000000000000000000000000000000000000000000000000000000000000000000000000000000000000000000000000X
X0000000000000000000000000000000000000000000000000000000000000000000000000000000000000000000000000X
X0000000000000066666666666666666666666666666666666000000000000000000000000000000000000000000000000X
X0000000000000066666666666666666666666666666666666000000000000000000000000000000000000000000000000X
X0000000000000066666666666666666666666666666666666000000000000000000000000000000000000000000000000X
X0000000000000066666666666666666666666666666666666000000000000000000000000000000000000000000000000X
X0000000000000066666666666666666666666666666666666000000000000000000000000000000000000000000000000X
X0000000000000000000000000000000000000000000000000000000000000000000000000000000000000000000000000X
X0000000000000000000000000000000000000000000000000000000000000000000000000000000000000000000000000X
X0000000000000000000000000000000000000000000777777777777777777777777777777777777777777700000000000X
X0000000000000000000000000000000000000000000777777777777777777777777777777777777777777700000000000X
X0000000000000000000000000000000000000000000777777777777777777777777777777777777777777700000000000X
X0000000000000000000000000000000000000000000777777777777777777777777777777777777777777700000000000X
X0000000000000000000000000000000000000000000777777777777777777777777777777777777777777700000000000X
X0000000000000000000000000000000000000000000777777777777777777777777777777777777777777700000000000X
X0000000000000000000000000000000000000000000777777777777777777777777777777777777777777700000000000X
X0000000000000000000000000000000000000000000777777777777777777777777777777777777777777700000000000X
X0000000000000000000000000000000000000000000777777777777777777777777777777777777777777700000000000X
X0000000000000000000000000000000000000000000000000000000000000000000000000000000000000000000000000X
X0000000000000000000000000000000000000000000000000000000000000000000000000000000000000000000000000X
X0000000000000000000000000000000000000000000000000000000000000000000000000000000000000000000000000X
X0000000000000000000000000000000000000000000000000000000000000000000000000000000000000000000000000X
X0000000000000000000000000000000000000000000000000000000000000000000000000000000000000000000000000X
X0000000000000000000000000000000000000000000000000000000000000000000000000000000000000000000000000X
X0000000000000000000000000000000000000000000000000000000000000000000000000000000000000000000000000X
X0000000000000000000000000000000000000000000000000000000000000000000000000000000000000000000000000X
X0000000000000000000000000000000000000000000000000000000000000000000000000000000000000000000000000X
X0000000000000000000000000000000000000000000000000000000000000000000000000000000000000000000000000X
X0000000000000000000000000000000000000000000000000000000000000000000000000000000000000000000000000X
X0000000000000000000000000000000000000888888888888888888888888888888888888888888888888888880000000X
X0000000000000000000000000000000000000888888888888888888888888888888888888888888888888888880000000X
X0000009999999999999900000000000000000888888888888888888888888888888888888888888888888888880000000X
X0000009999999999999900000000000000000888888888888888888888888888888888888888888888888888880000000X
X0000009999999999999900000000000000000888888888888888888888888888888888888888888888888888880000000X
X0000009999999999999900000000000000000888888888888888888888888888888888888888888888888888880000000X
X0000009999999999999900000000000000000888888888888888888888888888888888888888888888888888880000000X
X0000009999999999999900000000000000000888888888888888888888888888888888888888888888888888880000000X
X0000009999999999999900000000000000000888888888888888888888888888888888888888888888888888880000000X
X0000009999999999999900000000000000000888888888888888888888888888888888888888888888888888880000000X
X0000009999999999999900000000000000000888888888888888888888888888888888888888888888888888880000000X
X0000009999999999999900000000000000000888888888888888888888888888888888888888888888888888880000000X
X0000009999999999999900000000000000000888888888888888888888888888888888888888888888888888880000000X
X0000009999999999999900000000000000000888888888888888888888888888888888888888888888888888880000000X
X0000009999999999999900000000000000000888888888888888888888888888888888888888888888888888880000000X
X0000009999999999999900000000000000000888888888888888888888888888888888888888888888888888880000000X
X0000009999999999999900000000000000000888888888888888888888888888888888888888888888888888880000000X
X0000000000000000000000000000000000000888888888888888888888888888888888888888888888888888880000000X
X0000000000000000000000000000000000000888888888888888888888888888888888888888888888888888880000000X
X0000000000000000000000000000000000000888888888888888888888888888888888888888888888888888880000000X
X1111111111111111111111111111000000000888888888888888888888888888888888888888888888888888880000000X
X1111111111111111111111111111000000000888888888888888888888888888888888888888888888888888880000000X
X1111111111111111111111111111000000000888888888888888888888888888888888888888888888888888880000000X
X1111111111111111111111111111000000000888888888888888888888888888888888888888888888888888880000000X
X1111111111111111111111111111000000000888888888888888888888888888888888888888888888888888880000000X
X1111111111111111111111111111000000000888888888888888888888888888888888888888888888888888880000000X
X1111111111111111111111111111000000000000000000000000000000000000000000000000000000000000000000000X
X1111111111111111111111111111000000000000000000000000000000000000000000000000000000000000000000000X
X1111111111111111111111111111000000000000000000000000000000000000000000000000000000000000000000000X
X1111111111111111111111111111000000000000000000000000000000000000000000000000000000000000000000000X
XXXXXXXXXXXXXXXXXXXXXXXXXXXXXXXXXXXXXXXXXXXXXXXXXXXXXXXXXXXXXXXXXXXXXXXXXXXXXXXXXXXXXXXXXXXXXXXXXXX