XXXXXXXXXXXXXXXXXXXXXXXXXXXXXXXXXXXXXXXXXXXXXXXXXXXXXXXXXXXXXXXXXXXXXXXXXXXXXXXXXXXXXXXXXXXXXXXXXXXX
X000000000000000000000000000000000000000000000000000000000000000000000000000000000000000000000000XXX
X000444444444444444444444444444444444444444444444444444444444444444444444444444444444444444444000XXX
X000444444444444444444444444444444444444444444444444444444444444444444444444444444444444444444000XXX
X000000000000000000000000000000000000000000000000000000000000000000000000000000000000000000000000XXX
X000000000000000000000000000000000000000000000000000000000000000000000000000000000000000000000000XXX
X000000000000000000000000000000000000000000000000000000000000000000000000000000000000000000000000XXX
X000000000000002222222222222222222222222222000000000000000000000000000000000000000000000000000000XXX
X000000000000002222222222222222222222222222000000000000000000000000000000000000000000000000000000XXX
X000000000000002222222222222222222222222222000000000000000000000000000000033333330000000000000000XXX
X000000000000002222222222222222222222222222000000000000000000000000000000033333330000000000000000XXX
X000000000000002222222222222222222222222222000000000000000000000000000000033333330000000000000000XXX
X000000000000002222222222222222222222222222000000000000000000000000000000033333330000000000000000XXX
X000000000000002222222222222222222222222222000000000000000000000000000000033333330000000000000000XXX
X000000000000002222222222222222222222222222000000000000000000000000000000033333330000000000000000XXX
X000000000000002222222222222222222222222222000000000000000000000000000000033333330000000000000000XXX
X000000000000002222222222222222222222222222000000000000000000000000000000033333330000000000000000XXX
X000000000000002222222222222222222222222222000000000000000000000000000000033333330000000000000000XXX
X000000000000002222222222222222222222222222000000000000000000000000000000033333330000000000000000XXX
X000000000000000000000000000000000000000000000000000000000000000000000000033333330000000000000000XXX
X000000000000000000000000000000000000000000000000000000000000000000000000033333330000000000000000XXX
X000000000000000000000000000000000000000000000000000000000000000000000000033333330000000000000000XXX
X000000055555555555555555555555555555555555555555550000000000000000000000033333330000000000000000XXX
X000000055555555555555555555555555555555555555555550000000000000000000000033333330000000000000000XXX
X000000055555555555555555555555555555555555555555550000000000000000000000033333330000000000000000XXX
X000000055555555555555555555555555555555555555555550000000000000000000000033333330000000000000000XXX
X000000055555555555555555555555555555555555555555550000000000000000000000033333330000000000000000XXX
X000000055555555555555555555555555555555555555555550000000000000000000000033333330000000000000000XXX
X000000055555555555555555555555555555555555555555550000000000000000000000033333330000000000000000XXX
X000000055555555555555555555555555555555555555555550000000000000000000000033333330000000000000000XXX
X000000055555555555555555555555555555555555555555550000000000000000000000033333330000000000000000XXX
X000000055555555555555555555555555555555555555555550000000000000000000000033333330000000000000000XXX
X000000055555555555555555555555555555555555555555550000000000000000000000033333330000000000000000XXX
X000000055555555555555555555555555555555555555555550000000000000000000000000000000000000000000000XXX
X000000055555555555555555555555555555555555555555550000000000000000000000000000000000000000000000XXX
X000000055555555555555555555555555555555555555555550000000000000000000000000000000000000000000000XXX
X000000055555555555555555555555555555555555555555550000000000000000000000000000000000000000000000XXX
X000000055555555555555555555555555555555555555555550000000000000000000000000000000000000000000000XXX
X000000000000000000000000000000000000000000000000000000000000000000000000000000000000000000000000XXX
X000000000000000000000000000000000000000000000000000000000000000000000000000000000000000000000000XXX
X000000000000000000000000000000000000000000000000000000000000000000000000000000000000000000000000XXX
X000000000000000000000000000000000000000000000000000000000000000000000000000000000000000000000000XXX
X000000000000006666666666666666666666666666666666600000000000000000000000000000000000000000000000XXX
X000000000000006666666666666666666666666666666666600000000000000000000000000000000000000000000000XXX
X000000000000006666666666666666666666666666666666600000000000000000000000000000000000000000000000XXX
X000000000000006666666666666666666666666666666666600000000000000000000000000000000000000000000000XXX
X000000000000006666666666666666666666666666666666600000000000000000000000000000000000000000000000XXX
X000000000000000000000000000000000000000000000000000000000000000000000000000000000000000000000000XXX
X000000000000000000000000000000000000000000000000000000000000000000000000000000000000000000000000XXX
X000000000000000000000000000000000000000000077777777777777777777777777777777777777777770000000000XXX
X000000000000000000000000000000000000000000077777777777777777777777777777777777777777770000000000XXX
X000000000000000000000000000000000000000000077777777777777777777777777777777777777777770000000000XXX
X000000000000000000000000000000000000000000077777777777777777777777777777777777777777770000000000XXX
X000000000000000000000000000000000000000000077777777777777777777777777777777777777777770000000000XXX
X000000000000000000000000000000000000000000077777777777777777777777777777777777777777770000000000XXX
X000000000000000000000000000000000000000000077777777777777777777777777777777777777777770000000000XXX
X000000000000000000000000000000000000000000077777777777777777777777777777777777777777770000000000XXX
X000000000000000000000000000000000000000000077777777777777777777777777777777777777777770000000000XXX
X000000000000000000000000000000000000000000000000000000000000000000000000000000000000000000000000XXX
X000000000000000000000000000000000000000000000000000000000000000000000000000000000000000000000000XXX
X000000000000000000000000000000000000000000000000000000000000000000000000000000000000000000000000XXX
X000000000000000000000000000000000000000000000000000000000000000000000000000000000000000000000000XXX
X000000000000000000000000000000000000000000000000000000000000000000000000000000000000000000000000XXX
X000000000000000000000000000000000000000000000000000000000000000000000000000000000000000000000000XXX
X000000000000000000000000000000000000000000000000000000000000000000000000000000000000000000000000XXX
X000000000000000000000000000000000000000000000000000000000000000000000000000000000000000000000000XXX
X000000000000000000000000000000000000000000000000000000000000000000000000000000000000000000000000XXX
X000000000000000000000000000000000000000000000000000000000000000000000000000000000000000000000000XXX
X000000000000000000000000000000000000000000000000000000000000000000000000000000000000000000000000XXX
X000000000000000000000000000000000000088888888888888888888888888888888888888888888888888888000000XXX
X000000000000000000000000000000000000088888888888888888888888888888888888888888888888888888000000XXX
X000000999999999999990000000000000000088888888888888888888888888888888888888888888888888888000000XXX
X000000999999999999990000000000000000088888888888888888888888888888888888888888888888888888000000XXX
X000000999999999999990000000000000000088888888888888888888888888888888888888888888888888888000000XXX
X000000999999999999990000000000000000088888888888888888888888888888888888888888888888888888000000XXX
X000000999999999999990000000000000000088888888888888888888888888888888888888888888888888888000000XXX
X000000999999999999990000000000000000088888888888888888888888888888888888888888888888888888000000XXX
X000000999999999999990000000000000000088888888888888888888888888888888888888888888888888888000000XXX
X000000999999999999990000000000000000088888888888888888888888888888888888888888888888888888000000XXX
X000000999999999999990000000000000000088888888888888888888888888888888888888888888888888888000000XXX
X000000999999999999990000000000000000088888888888888888888888888888888888888888888888888888000000XXX
X000000999999999999990000000000000000088888888888888888888888888888888888888888888888888888000000XXX
X000000999999999999990000000000000000088888888888888888888888888888888888888888888888888888000000XXX
X000000999999999999990000000000000000088888888888888888888888888888888888888888888888888888000000XXX
X000000999999999999990000000000000000088888888888888888888888888888888888888888888888888888000000XXX
X000000999999999999990000000000000000088888888888888888888888888888888888888888888888888888000000XXX
X000000000000000000000000000000000000088888888888888888888888888888888888888888888888888888000000XXX
X000000000000000000000000000000000000088888888888888888888888888888888888888888888888888888000000XXX
X000000000000000000000000000000000000088888888888888888888888888888888888888888888888888888000000XXX
X111111111111111111111111111100000000088888888888888888888888888888888888888888888888888888000000XXX
X111111111111111111111111111100000000088888888888888888888888888888888888888888888888888888000000XXX
X111111111111111111111111111100000000088888888888888888888888888888888888888888888888888888000000XXX
X111111111111111111111111111100000000088888888888888888888888888888888888888888888888888888000000XXX
X111111111111111111111111111100000000088888888888888888888888888888888888888888888888888888000000XXX
X111111111111111111111111111100000000088888888888888888888888888888888888888888888888888888000000XXX
X111111111111111111111111111100000000000000000000000000000000000000000000000000000000000000000000XXX
X111111111111111111111111111100000000000000000000000000000000000000000000000000000000000000000000XXX
X111111111111111111111111111100000000000000000000000000000000000000000000000000000000000000000000XXX
X111111111111111111111111111100000000000000000000000000000000000000000000000000000000000000000000XXX
XXXXXXXXXXXXXXXXXXXXXXXXXXXXXXXXXXXXXXXXXXXXXXXXXXXXXXXXXXXXXXXXXXXXXXXXXXXXXXXXXXXXXXXXXXXXXXXXXXXX