XXXXXXXXXXXXXXXXXXXXXXXXXXXXXXXXXXX
XXXXXXXXXXXXXXXXXXXXXXXXXXXXXXXXXXX
XXX00000XXXXXXXXXX0XXXXXX0000XXXXXX
XXXXXX0000000000XX00XXX000000XX00XX
XXXXXX000000000000000X0000000XX0XXX
XXXXXX0000000X0000000000XX000XX0XXX
XXXXXXX00000XXXX0000X000XXX00XX00XX
XX22XXXX00000XXX00000000XX000XXX0XX
XX222XXXXX0000XXX00000000X000XXX0XX
X022222XXXXX00XXXX0000X0000000XX0XX
XX22222222XXX0XXXX000000000000XX0XX
XX22X2222222200000XX000X0000000X0XX
XX22222222222X00000X000XXX00X00X0XX
XX222222222XXXXX0000X0000XX000000XX
XX222XX2222XXXXXX000X00000X00000XXX
XXXXXXXX22222XXXX000X00000000000XXX
XXXXXXXXXX22222200000000000000000XX
XXXXXXXXXXXXX2220000000X00000000XXX
XXXXXX1111XXXXX2000000000000000000X
XXXXX11XX1111XXX00X0003333XXXXX000X
XXXX111XX11111XX0000003333XXXXXXXXX
XXXX11XXXX11111X0000XX3333XXXXXX0XX
XXX111XXXX111110000XXX33333XXXX00XX
XXX1111X11111110000XXX33X33XXX000XX
XXX11111111111100000XX30XX33XX000XX
XX1111111XXX11100X000X33XX33XX000XX
X11111111XXXXXXXXX000XX33X33XX000XX
X1XX11111XXXXXXXXXX00XX33333XX000XX
X1XX1111XXXXXXXXXXX00XX3333XXX00XXX
X1X11111XXXXXXXXXX000XXX333XX000XXX
X1X1111XXXXXXXXXX000000XXXXX0000XXX
X11111XXXXXXXXXX000000000000000XXXX
X111XXXXXXXXXXX000000XXXXX00000XXXX
X11XXXXXXXXXXXXXXXXXXXXXXXX000XXXXX
XXXXXXXXXXXXXXXXXXXXXXXXXXXXXXXXXXX