XXXXXXXXXXXXXXXXXXXXXXXXXXXXXXXXXXX
XXXXXXXXXXXXXXXXXXXXXXXXXXXXXXXXXXX
XXX00000XXXXXXXXXX0XXXXXX0000XXXXXX
XXXXXX0000000000XX00XXX000000XX00XX
XXXXXX000000000000000X0000000XX0XXX
XXXXXX0000000X0000000000XX000XX0XXX
XXXXXXX00000XXXX0000X000XXX00XX00XX
XX00XXXX00000XXX00000000XX000XXX0XX
XX000XXXXX0000XXX00000000X000XXX0XX
X000000XXXXX00XXXX0000X0000000XX0XX
XX00000000XXX0XXXX000000000000XX0XX
XX00X0000000000000XX000X0000000X0XX
XX00000000000X00000X000XXX00X00X0XX
XX000000000XXXXX0000X0000XX000000XX
XX000XX0000XXXXXX000X00000X00000XXX
XXXXXXXX00000XXXX000X00000000000XXX
XXXXXXXXXX00000000000000000000000XX
XXXXXXXXXXXXX0000000000X00000000XXX
XXXXXX1111XXXXX0000000000000000000X
XXXXX11XX1111XXX00X0000000XXXXX000X
XXXX111XX11111XX0000000000XXXXXXXXX
XXXX11XXXX11111X0000XX0000XXXXXX0XX
XXX111XXXX111111000XXX00000XXXX00XX
XXX1111X11111111100XXX00X00XXX000XX
XXX11111111111111000XX00XX00XX000XX
XX1111111XXX11111X000X00XX00XX000XX
X11111111XXXXXXXXX000XX00X00XX000XX
X1XX11111XXXXXXXXXX00XX00000XX000XX
X1XX1111XXXXXXXXXXX00XX0000XXX00XXX
X1X11111XXXXXXXXXX000XXX000XX000XXX
X1X1111XXXXXXXXXX000000XXXXX0000XXX
X11111XXXXXXXXXX000000000000000XXXX
X111XXXXXXXXXXX000000XXXXX00000XXXX
X11XXXXXXXXXXXXXXXXXXXXXXXX000XXXXX
XXXXXXXXXXXXXXXXXXXXXXXXXXXXXXXXXXX
