XXXXXXXXXXXXXXXXXXXXXXXXXXXXXXXXXXXXXXXXXXXXXXXXXXXXXXXXXXXXXXXXXXXXXXXXXXXXXXXXXXXXXXXXXXXXXXXXXXXX
XXXXXXXXXXXXXXXXXXXXXXXXXXXXXXXXXXXXXXXXXXXXXXXXXXXXXXXXXXXXXXXXXXXXXXXXXXXXXXXXXXXXXXXXXXXXXXXXXXXX
XXXXXXXXXXXXXXXXXXXXXXXXXXXXXXXXXXXXXXXXXXXXXXXXXXXXXXXXXXXXXXXXXXXXXXXXXXXXXXXXXXXXXXXXXXXXXXXXXXXX
XXXXXXXXXXXXXXXXXXXXXXXXXXXXXXXXXXXXXXXXXXXXXXXXXXXXXXXXXXXXXX000000XXXXXXXXXXXXXXXXXXXXXXXXXXXXXXXX
XXXXXXXXXXXXXXXXXXXXXXXXXXXXXXXXXXXXXXXXXXX000000000XXXX000000077770000000XXXXXXXXXXXXXXXXXXXXXXXXXX
XXXXXXXXXXXXXXXXXXXXXXXXXXXXXXXXXXXXXXXXXXX0XX7XXX70XXXX070000077770000070XXXXXXXXXXXXXXXXXXXXXXXXXX
XXXXXXXXXXXXXXXXXXXXXXXXXXXXXXXXXXXXXXXXXXX077777770XXXX070XXX077770XXX070XXXXXXXXXXXXXXXXXXXXXXXXXX
XXXXXXXXXXXXXXXXXXXXXXXXXXXXXXXXXXXXXXXXXXX0XX7XXX70XXXX070XXX077770XXX070XXXXXXXXXXXXXXXXXXXXXXXXXX
XXXXXXXXXXXXXXXXXXXXXXXXXXXXXXXXXXXXXXXXXXX0777777700000070XXX077770XXX070XXXXXXXXXXXXXXXXXXXXXXXXXX
XXXXXXXXXXXXXXXXXXXXXXXXXXXXXXXXXXXXXXXXXXX0777777700000070XXX077770XXX070XXXXXXXXXXXXXXXXXXXXXXXXXX
XXXXXXXXXXXXXXXXXXXXXXXXXXXXXXXXXXXXXXXXXXX0777777700000070XXX077770XXX070XXXXXXXXXXXXXXXXXXXXXXXXXX
XXXXXXXXXXXXXXXXXXXXXXXXXXXXXXXXXXXXXXXXXXX0777777700000070XXX077770XXX070XXXXXXXXXXXXXXXXXXXXXXXXXX
XXXXXXXXXXXXXXXXXXXXXXXXXXXXXXXXXXXXXXXXXXX0XX7XXX70XXXX070XXX077770XXX070XXXXXXXXXXXXXXXXXXXXXXXXXX
XXXXXXXXXXXXXXXXXXXXXXXXXXXXXXXXXXXXXXXXXXX077777770XXXX070000077770000070XXXXXXXXXXXXXXXXXXXXXXXXXX
XXXXXXXXXXXXXXXXXXXXXXXXXXXXXXXXXXXXXXXXXXX0XX7XXX70XXXX077777777777777770XXXXXXXXXXXXXXXXXXXXXXXXXX
XXXXXXXXXXXXXXXXXXXXXXXXXXXXXXXXXXXXXXXXXXX077777770XXXX000000777777000000XXXXXXXXXXXXXXXXXXXXXXXXXX
XXXXXXXXXXXXXXXXXXXXXXXXXXXXXXXXXXXXXXXXXXX000000000XXXXXXXXX07777770XXXXXXXXXXXXXXXXXXXXXXXXXXXXXXX
XXXXXXXXXXXXXXXXXXXXXXXXXXXXXXXXXXXXXXXXXXXXXXXXXXXXXXXXXXXXX07777770XXXXXXXXXXXXXXXXXXXXXXXXXXXXXXX
XXXXXXXXXXXXXXXXXXXXXXXXXXXXXXXXXXXXXXXXXXXXXXXXXXXXXXXXXXXXX07777770XXXXXXXXXXXXXXXXXXXXXXXXXXXXXXX
XXXXXXXXXXXXXXXXXXXXXXXXXXXXXXXXXXXXXXXXXXXXXXXXXXXXXXXXXXXXX07777770XXXXXXXXXXXXXXXXXXXXXXXXXXXXXXX
XXXXXXXXXXXXXXXXXXXXXXXXXXXXXXXXXXXXXXXXXXXXXXXXXXXXXXXXXXXXX07777770XXXXXXXXXXXXXXXXXXXXXXXXXXXXXXX
X00000000XX00000000XX00000000XXXXXXXXXXXXXXXXXXXXXXXXXXXXXXXX07777770XXXXXXXXXXXXXXXXXXXXXXXXXXXXXXX
X00000000XX00000000XX00000000XXXXXXXXXXXXXXXXXXXXXXXXXXXXXXXX07777770XXXXXXXXXXXXXXXXXXXXXXXXXXXXXXX
X00XXXX00XX00XXXX00XX00XXXX00XXXXXXXXXXXXXX00000000000000000000000000000000000000000000XXXXXXXXXXXXX
X00XXXX00XX00XXXX00XX00XXXX00XXXXXXXXXXXXXX04444000000000000000000000000000000000044440XXXXXXXXXXXXX
X00000000XX00000000XX00000000XXXXXXXXXXXXXX04444000000000000000000000000000000000044440XXXXXXXXXXXXX
X00000000XX00000000XX00000000XXXXXXXXXXXXXX04400000000000000000000000000000000000000440XXXXXXXXXXXXX
X00XXXX00XX00XXXX00XX00000000XXXXXXXXXXXXXX0440XXXXXXXXXXXXXXXXXXXXXXXXXXXXXXXXXXXX0440XXXXXXXXXXXXX
X00XXXX00XX00XXXX00XX00XXXX00XXXXXXXXXXXXXX0000XXXXXXXXXXXXXXXXXXXXXXXXXXXXXXXXXXXX0000XXXXXXXXXXXXX
X00000000XX00000000XX00XXXX00XXXXXXXXXXXXXX0000XXXXXXXXXXXXXXXXXXXXXXXXXXXXXXXXXXXX0000XXXXXXXXXXXXX
X00000000XX06X66X60XX00000000XXXXXXXXXXXXXX0000XXXXXXXXXXXXXXXXXXXXXXXXXXXXXXXXXXXX0000XXXXXXXXXXXXX
X00XXXX00XX06666660XX00000000XXXXXXXXXXXXXX0000XXXXXXXXXXXXXXXXXXXXXXXXXXXXXXXXXXXX0000XXXXXXXXXXXXX
X00XXXX00XX06X66X60XX00XXXX00XXXXXXXXXXXXXX0000XXXXX000X000X000XXXX000X000X000XXXXX0000XXXXXXXXXXXXX
X00000000XX06666660XX00XXXX00XXXXXXXXXXXXXX0000XXXXX0X0X0X0X0X0XXXX0X0X0X0X0X0XXXXX0000XXXXXXXXXXXXX
X06X66X60XX06X66X60XX00000000XXXXXXXXXXXXXX0000XXXXX050X050X050X00X050X050X050XXXXX0000XXXXXXXXXXXXX
X06666660XX06666660XX06666660XXXXXXXXXXXXXX0000XXXXX05000500050000005000500050XXXXX0000XXXXXXXXXXXXX
X06666660XX06666660XX06666660XXXXXXXXXXXXXX0000XXXXX05555555555555555555555550XXXXX0000XXXXXXXXXXXXX
X00000000XX00000000XX00000000XXXXXXXXXXXXXX0000XXXXX05000500050000005000500050XXXXX0000XXXXXXXXXXXXX
XXXX00XXXXXXXX00XXXXXXXX00XXXXXXXXXXXXXXXXX0000XXXXX050X050X050X00X050X050X050XXXXX0000XXXXXXXXXXXXX
XXXX00XXXXXXXX00XXXXXXXX00XXXXXXXXXXXXXXXXX0000XXXXX0X0X0X0X0X0X00X0X0X0X0X0X0XXXXX0000XXXXXXXXXXXXX
XXX0000XXXXXX0000XXXXXX0000XXXXXXXXXXXXXXXX0000XXXXX000X000X000X00X000X000X000XXXXX0000XXXXXXXXXXXXX
XXX066000000006600000000660XXXXXXXXXXXXXXXX0000XXXXXXXXXXXXXXXXX00XXXXXXXXXXXXXXXXX0000XXXXXXXXXXXXX
XXX066000000006600000000660XXXXXXXXXXXXXXXX0000XXXXXXXXXXXXXXXXX00XXXXXXXXXXXXXXXXX0000XXXXXXXXXXXXX
XXX0000XXXXXX0000XXXXXX0000XXXXXXXXXXXXXXXX0000XXXXXXXXXXXXXXXXX00XXXXX000000XXXXXX0000XXXXXXXXXXXXX
XXXX00XXXXXXXX00XXXXXXXXXXXXXXXXXXXXXXXXXXX0000XXXXXXXXXXXXXXXX0000XXXX0X55X0XXXXXX0000XXXXXXXXXXXXX
XXXX00XXXXXXXX00XXXXXXXX00XXXXXXXXXXXXXX000X00000XXXXXXXXXXXXXX05500000055550XXXXXX0000XXXXXXXXXXXXX
XX000000XXXX000000XXXX000000XXXXXXXXXXXX044444440XXXXXXXXXXXXXX05500000055550XXXXXX0000XXXXXXXXXXXXX
XX06666000000666600000066660000000000000044444440XXXXXXXXXXXXXX0000XXXX0X55X0XXXXXX0000XXXXXXXXXXXXX
XX06666000000666600000066660000000000000044444440XXXXXXXXXXXXXXX00XXXXX000000XXXXXX0000XXXXXXXXXXXXX
XX066660XXXX066660XXXX066660XXXXXXXXXXXX044444440XXXXXXXXXXXXXXX00XXXXXXXXXXXXXXXXX0000XXXXXXXXXXXXX
XX000000XXXX000000XXXX000000XXXXXXXXXXXX000000000XXXXXXXXXXXXX000000XXXXXXXXXXXXXXX0000XXXXXXXXXXXXX
XXXXXXXXXXXXXXXXXXXXXXXXXXXXXXXXXXXXXXXXXXX0000XXXXXXXXXXXXXXX000000XXXXXXXXXXXXXXX0000XXXXXXXXXXXXX
XXXXXXXXXXXXXXXXXXXXXXXXXXXXXXXXXXXXXXXXXXX0000XXXXXXXXXXXXX0000550000XXXXXXXXXXXXX0000XXXXXXXXXXXXX
XXXX000000XXXXXX00000000XXXXXXXXXXXXXXXX000X00000XXXXXXXXXXX000X55X000XXXXXXXXXXX00X00000XX000000XXX
XXXX088880000000088888800000000000000000044444440000000000000055555500000000000000444444000033330XXX
XXXX088880000000088888800000000000000000044444440000000000000055555500000000000000444444000033330XXX
XXXX000000XXXXXX00000000XXXXXXXXXXXXXXXX044444440XXXXXXXXXXX000X55X000XXXXXXXXXXX0444444000033330XXX
XXXXXX00XXXXXXXXXXX00XXXXXXXXXXXXXXXXXXX044444440XXXXXXXXXXX0000550000XXXXXXXXXXX04444440XX000000XXX
XXXXXX00XXXXXXXXXXX00XXXXXXXXXXXXXXXXXXX000000000XXXXXXXXXXXXX000000XXXXXXXXXXXXX00000000XXXX00XXXXX
X000XX00XXXXXXXXXXX00XXXXXXXXXXXXXXXXXXXXXX0000XXXXXXXXXXXXXXX000000XXXXXXXXXXXXXXX0000XXXXXX00XXXXX
X0X00000XXXXXXXXXXX00XXXXXXXXXXXXXXXXXXXXXX0000XXXXXXXXXXXXXXXXX00XXXXXXXXXXXXXXXXX0000XXXXXX00XXXXX
X0800000XXX00000000000XX00000XXXXXXXXXXXXXX0000XXXXXXXXXXXXXXXXX00XXXXXXXXXXXXXXXXX0000XXXXXX00XXXXX
X000XX00XXX0X8X8X88880XX08880XXXXXXXXXXXXXX0000XXXXXXXXXXXXXXXXX00XXXXXXXXXXXXXXXXX0000XXXXXXXXXXXXX
XXXXXX00XXX08888888880XX08880XXXXXXXXXXXXXX0000XXXXXXXXXXXXXXXXX00XXXXXXXXXXXXXXXXX0000XXXXXXXXXXXXX
X000XX00XXX0X8X8X888800008880XXXXXXXXXXXXXX0000XXXXXXXXXXXXXXXXX00XXXXXXXXXXXXXXXXX0000XXXXXXXXXXXXX
X0X00000XXX088888888800008880XXXXXXXXXXXXXX0000XXXXXXXXXXXXXXXXX00XXXXXXXXXXXXXXXXX0000XXXXXXXXXXXXX
X0800000XXX0X8X8X88880XX08880XXXXXXXXXXXXXX0000XXXXXXXXXXXXXXXXX00XXXXXXXXXXXXXXXXX0000XXXXXXXXXXXXX
X000XX00XXX08888888880XX08880XXXXXXXXXXXXXX0000XXXXXXXXXXXXXXXXX00XXXXXXXXXXXXXXXXX0000XXXXXXXXXXXXX
XXXXXX00XXX0X8X8X88880XX08880XXXXXXXXXXXXXX0000XXXXXXXXXXXXXXXXX00XXXXXXXXXXXXXXXXX0000XXXXXX00XXXXX
X000XX00XXX00000000000XX00000XXXXXXXXXXXXXX0000XXXXXXXXXXXXXXXXX00XXXXXXXXXXXXXXXXX0000XXXXXX00XXXXX
X0X00000XXXXXXXXXXX00XXXXXXXXXXXXXXXXXXXXXX0000XXXXXXXXXXXXXXXX0000XXXXXXXXXXXXXXXX0000XXXXXX00XXXXX
X0800000XXXXXXXXXXX00XXXXXXXXXXXXXXXXXXXXXX0000XXXXXXXXXXXXXXXX0440XXXXXXXXXXXXXXXX0000XXXXXX00XXXXX
X000XX00XXXXXXXXXXX00XXXXXXXXXXXXXXXXXXX000X000000XXXXXXXXXXXXX0440XXXXXXXXXXXXXX00X00000XX000000XXX
XXXXXX00XXXXX000000000000000000000000000044444444000000000000000440000000000000000444444000033330XXX
X0XX00000XXXX011100000000000000000000000044444444000000000000000440000000000000000444444000033330XXX
X08888880XXXX011100000000000000000000000044444444000000000000000440000000000000000444444000033330XXX
X08888880XXXX0110000000000000000000000000444444440000000000000000000000000000000004444440XX000000XXX
X00000000XXXX0000XXXXXXXXXXXXXXXXXXXXXXX0444444440XXXXXXXXXXXXXXXXXXXXXXXXXXXXXXX04444440XXXXXXXXXXX
XXXXXX00XXXXX0000XXXXXXXXXXXXXXXXXXXXXXX0000000000XXXXXXXXXXXXXXXXXXXXXXXXXXXXXXX00000000XXXXXXXXXXX
XXXXXX00XXXXX0000XXXXXXXXXXXXXXXXXXXXXXXXXXXXXXXXXXXXXXXXXXXXXXXXXXXXXXXXXXXXXXXXXXX00XXXXXXXXXXXXXX
X00000000XXXX0000XXXXXXXXXXXXXXXXXXXXXXXXXXXXXXXXXXXXXXXXXXXXXXXXXXXXXXXXXXXXXXXXXXX00XXXXXXXXXXXXXX
X00001110XXXX0000XXX00000000000000000000XXXXXXXXXXXXXXXXXXXXX0000XX000000000000XX00000000000000000XX
X0XX01X10XXXX0000XXX00000000000000000000XXXXXXXXXXXXXXXXXXXXX022000022222222220XX03333300000000000XX
X0XX01110XXXX0000XXX00XXXX00XXXX00XXXX00XX000000XXXXXXXXXXXXX022000022222222220XX0333330XXXXXXXX00XX
X0XX01110XXXX0000XXX00XXXX00XXXX00XXXX00XX022220XXXXXXXXXXXXX0220XX022222222220XX0333330XXXXXXXX00XX
X01111X10XXXX0000XXX00XXXX00XXXX00XXXX0000022220XXXXXXXXXXXXX0220XX022222222220XX03333300000000000XX
X01111110XXXX0000XXX00XXXX00XXXX00XXXX00XX022220XXXXXXXXXXXXX0220XX0222222222200003333333333333330XX
X00001110XXXX0000XXX00000000000000000000XX022220XXXXXXXXXXXXX0220XX0222222222200003333333333333330XX
X0XX01X10XXXX0000XXX01111111111111111110XX000000XXXXXXXXXXXXX0000XX000000000000XX03333333333333330XX
X0XX01110XXXX0000XXX01X11X11X11X11X11X10XXXXXXXXXXXXXXXXXXXXXX00XXXX00XXXXXXXXXXX0000003X3X3000000XX
X0XX01110XXXX0000XXX01111111111111111110XXXXXXXXXXXXXXXX000XXX00XXXX00XXXXXXXXXXX00000033333000000XX
X01111X10XXXX0000XXX01X11X11X11X11X11X10XX000000XXX00000020XX0000XX0000XXXXXXXXXX00XX0033X3300XX00XX
X01111110XXXX0110XXX01111111111111111110XX022220XXX00000020XX0220XX0000XXXXXXXXXX00XX003333300XX00XX
X0000111000000110000011111111111111111100002222000000XXX020XX0220XX0000XXXXXXXXXX00XXX0000000XXX00XX
X0XX01X111111111111111111111111111111110XX02222000000XXX020XX0220XX0000XXXXXXXXXX00XXXX00000XXXX00XX
X0XX011100000011000001X11X11X11X11X11X10XX022220XXX00XXX020XX0220XX0000XXXXXXXXXX00XXXXXXXXXXXXX00XX
X0XX01110XXXX0000XXX00000000000000000000XX000000XXX00XXX020000220XX0000XXXXXXXXXX00XXXXXXXXXXXXX00XX
X01111X10XXXXXXXXXXXXXXXXXXXXXXXXXXXXXXXXXXXXXXXXXX00XXX020000220XX0000XXXXXXXXXX00000000000000000XX
X01111110XXXXXXXXXXXXXXXXXXXXXXXXXXXXXXXXXXXXXXXXXXXXXXX000000220XX0000XXXXXXXXXX03333333333333330XX
XXXXXXXXXXXXXXXXXXXXXXXXXXXXXXXXXXXXXXXXXXXXXXXXXXXXXXXXXXXXXXXXXXXXXXXXXXXXXXXXXXXXXXXXXXXXXXXXXXXX
