XXXXXXXXXXXXXXXXXXXXXXXXXXXXXXXXXXX
XXXXXXXXXXXXXXXXXXXXXXXXXXXXXXXXXXX
XXXOOOOOXXXXXXXXXXOXXXXXXOOOOXXXXXX
XXXXXXOOOOOOOOOOXXOOXXXOOOOOOXXOOXX
XXXXXXOOOOOOOOOOOOOOOXOOOOOOOXXOXXX
XXXXXXOOOOOOOXOOOOOOOOOOXXOOOXXOXXX
XXXXXXXOOOOOXXXXOOOOXOOOXXXOOXXOOXX
XXOOXXXXOOOOOXXXOOOOOOOOXXOOOXXXOXX
XXOOOXXXXXOOOOXXXOOOOOOOOXOOOXXXOXX
XOOOOOOXXXXXOOXXXXOOOOXOOOOOOOXXOXX
XXOOOOOOOOXXXOXXXXOOOOOOOOOOOOXXOXX
XXOOXOOOOOOOOOOOOOXXOOOXOOOOOOOXOXX
XXOOOOOOOOOOOXOOOOOXOOOXXXOOXOOXOXX
XXOOOOOOOOOXXXXXOOOOXOOOOXXOOOOOOXX
XXOOOXXOOOOXXXXXXOOOXOOOOOXOOOOOXXX
XXXXXXXXOOOOOXXXXOOOXOOOOOOOOOOOXXX
XXXXXXXXXXOOOOOOOOOOOOOOOOOOOOOOOXX
XXXXXXXXXXXXXOOOOOOOOOOXOOOOOOOOXXX
XXXXXXOOOOXXXXXOOOOOOOOOOOOOOOOOOOX
XXXXXOOXXOOOOXXXOOXOOOOOOOXXXXXOOOX
XXXXOOOXXOOOOOXXOOOOOOOOOOXXXXXXXXX
XXXXOOXXXXOOOOOXOOOOXXOOOOXXXXXXOXX
XXXOOOXXXXOOOOOOOOOXXXOOOOOXXXXOOXX
XXXOOOOXOOOOOOOOOOOXXXOOXOOXXXOOOXX
XXXOOOOOOOOOOOOOOOOOXXOOXXOOXXOOOXX
XXOOOOOOOXXXOOOOOXOOOXOOXXOOXXOOOXX
XOOOOOOOOXXXXXXXXXOOOXXOOXOOXXOOOXX
XOXXOOOOOXXXXXXXXXXOOXXOOOOOXXOOOXX
XOXXOOOOXXXXXXXXXXXOOXXOOOOXXXOOXXX
XOXOOOOOXXXXXXXXXXOOOXXXOOOXXOOOXXX
XOXOOOOXXXXXXXXXXOOOOOOXXXXXOOOOXXX
XOOOOOXXXXXXXXXXOOOOOOOOOOOOOOOXXXX
XOOOXXXXXXXXXXXOOOOOOXXXXXOOOOOXXXX
XOOXXXXXXXXXXXXXXXXXXXXXXXXOOOXXXXX
XXXXXXXXXXXXXXXXXXXXXXXXXXXXXXXXXXX
